        #######
       ##A    ##
    ####       #############
    #  #                   #
    #  ####           @    #
    #             ##########
#####                      #
#                          #
#              @           #
########     #######       #
#                          #####
#####                         ####
    #                            ##        
    #        #####              ###
    ###@@    #OO               ###
      #      #OO              ##
      #########################