##########
#  A     #
#  @     #
#        #
#        #
##   #####
#        #
#     O  #
##########