################
#    O O       #
#              #
#  @    #      #
#       #      #
##   ####      #
#   A   @      #
#       #      #
################